9999999999999999999999
9000000000000000000009
9000000000000000000009
9000000000100000000009
9000000000000000000009
9000000000000000000009
9999999999900000000009
9100000000000000000009
9999999999999999999999