999999999999999999999
910000000000000000029
999999999909999999999
930000000000000000049
999999999909999999999
900000000000000000009
959999999999999999989
979000000000000000969
999000000000000000999