99999999999999999999999
91000000000000000000059
99999999999999999999999
92000000000000000000069
99999999999999999999999
93000000000000000000079
99999999999999999999999
94000000000000000000089
99999999999999999999999