99999999999999999999999
91000000000000000000029
99999999999099999999999
00000000009090000000000
00000000009090000000000
00000000009090000000000
00000000009090000000000
00000000009090000000000
00000000009090000000000
00000000009090000000000
00000000009090000000000
00000000009090000000000
00000000009090000000000
00000000009690000000000
00000000009590000000000
00000000009990000000000