9999999999999999999999
9000000004992000000009
9099999999999999999909
9090000000000000000909
9090000000000000000909
9090000000000000000909
9090000000000000000909
9090000000000000000909
9090000000000000000909
9090000000000000000909
9090000000000000000909
9090000000000000000909
9090000000000000000909
9090000000000000000909
9090000000000000000909
9890000000000000000969
9990000000000000000999